R   750 750
NO  ./texture/brick.xpm
SO  ./texture/colorstone.xpm
WE  ./texture/rock.xpm
EA  ./texture/eagle.xpm

S   ./texture/barrel.xpm
F   220,100,0
C   225,30,0

1111111111
1000000001
1000000001
1000020001
1000000001
1000000001
10000N0001
1111111111
