R   1250 750
NO  ./texture/brick.xpm
SO  ./texture/colorstone.xpm
WE  ./texture/rock.xpm
EA  ./texture/eagle.xpm

S   ./texture/barrel.xpm
F    0 , 250,60
C   5,30,105

1111111111
1000000001
1000000001
1000020001
1000000001
1000000001
10000N0001
1111111111
