R   1250    1000
NO  texture/eagle.xpm
SO  texture/moss.xp
WE  texture/rock.xpm
EA  texture/blue_brick.xpm
S   texture/barrel.xpm
C   30,127,203
F   146,109,39

        1111111111111111111111111
        1000000000110000000000001
        1011002001110000002000001
        1001000000000000000000001
111111111011200001110000000000001
100000000011000001110111110111111
11110111111111011100000010001
11110111111111011101010010001
11000000110101011100000000001
10002000000000001100000010001
10000000000000001101010010001
11000001110101011111011110N01
11110111 1110101 101111010001
11111111 1111111 111111111111
