R   1000	500
NO  ./texture/rock.xpm
SO  ./texture/south.xpm
WE  ./texture/west.xpm
EA  ./texture/east.xpm
S   ./path_to_the_sprite_texture
F   220,100,0
C   225,30,0


  
1111
1  1
1111
  
 111  1 1 
 111  111 
  1111001  
      101   
 1111 101    
 11011101   
 100N000011  
 1000000011  
 100011111 
 1001 10011  
 1001  100011  
 1000110011  
 1111 111 
