R   750 750
NO  ./texture/eagle.xpm
SO  ./texture/rock.xpm
WE  ./texture/blue_brick.xpm
EA  ./texture/moss.xpm
S   ./texture/wood.xpm
F   20,148,20
C   119,181,254

111111111111
101010101001
110000000011
100000000001
110000W01011
100000000001
110000000011
101010101001
111111111111
